10
-.P.-.-.-.-.-.-.-.-
-.-.-.W.-.P.-.-.-.G
P.-.-.-.-.-.-.P.-.-
-.-.-.-.-.P.-.-.-.-
-.-.P.-.-.-.-.-.-.-
-.-.-.-.-.-.P.-.-.-
-.-.-.-.-.-.-.-.-.-
-.-.-.-.-.-.-.P.-.-
-.-.-.-.-.-.-.-.-.-
A.-.-.-.-.-.-.-.-.-