10
-.-.P_G.-.-.-.-.-.-.-
-.-.H_P.-.-.-.-.-.-.-
P_G.-.-.-.-.-.-.P.-.P
-.-.-.P.-.-.-.-.-.-
-.-.-.G.-.-.-.P_G.-.-
-.H_P.-.-.-.-.-.-.-.-
-.-.-.P_G.-.-.-.-.P.-
-.-.P.-.-.-.-.-.W.-
-.-.-.-.-.-.-.H_P.-.-
A.-.-.P.-.-.-.-.-.-