5
-.-.-.P.-
-.-.-.-.-
-.-.P.W.P
-.-.-.G.-
A.-.-.P.-