8
-.-.-.-.-.-.-.P
-.-.-.-.-.-.-.-
-.P.-.-.-.-.-.-
-.P.-.-.-.P.-.P
-.-.-.-.-.G.-.-
W.-.-.-.-.P.-.-
-.-.-.-.-.-.-.-
A.-.-.-.-.-.-.-