7
-.-.-.-.-.P.P
-.-.-.-.P.-.-
-.P.-.-.G.-.-
-.-.-.-.-.-.P
-.-.-.-.-.P.-
-.-.W.-.P.-.-
A.-.-.-.-.-.-