10
P.-.-.-.-.P.P.-.-.-
P.-.-.-.P.-.P.-.-.-
-.-.-.-.-.-.-.-.-.-
-.-.-.-.-.G.P.-.-.-
-.-.-.-.-.P.-.-.-.-
-.-.W.-.P.-.-.-.-.-
-.-.-.-.-.-.-.-.P.-
-.-.-.P.-.-.-.-.-.-
-.-.-.-.-.P.-.-.-.-
A.-.-.-.-.-.-.-.-.-