8
H_P.-.-.-.-.-.-.P
-.-.H_P.-.-.-.-.-
P.-.-.-.P_G.-.-.-
-.P.-.-.-.P.-.P
-.-.-.-.-.-.-.-
W.-.-.-.-.-.G.P_G
-.-.-.P_G.-.-.-.-
A.-.-.-.-.-.-.-