10
P_G.-.-.H_P.-.P.P.-.-.-
-.-.-.-.P.-.-.-.-.-
-.P.-.-.G.H_P.-.-.-.-
-.H_P.-.-.-.-.P.-.-.-
P_G.-.-.-.P.-.-.-.-.-
-.-.-.-.-.-.G.P_G.-.-
W.-.-.-.-.-.H_P.-.-.-
-.-.-.-.P.-.-.-.-.-
-.-.-.-.-.-.-.-.P.-
A.-.-.-.-.P_G.-.-.-.-